********************
*..............**..*
*........*.........*
*..................*
*........**........*
*........**........*
*****...***........*
*..................*
*........***.....***
********************