*,*,*,*,*,*,*,*,*,*,*,*,*,*,*,*,*,*,*,*
*,.,.,.,.,.,.,.,.,.,.,.,.,.,.,*,*,.,.,*
*,.,.,.,.,.,.,.,.,*,.,.,.,.,.,.,.,.,.,*
*,.,.,.,.,.,.,.,.,.,.,.,.,.,.,.,.,.,.,*
*,.,.,.,.,.,.,.,.,*,*,.,.,.,.,.,.,.,.,*
*,.,.,.,.,.,.,.,.,*,*,.,.,.,.,.,.,.,.,*
*,*,*,*,*,.,.,.,*,*,*,.,.,.,.,.,.,.,.,*
*,.,.,.,.,.,.,.,.,.,.,.,.,.,.,.,.,.,.,*
*,.,.,.,.,.,.,.,.,*,*,*,.,.,.,.,.,*,*,*
*,*,*,*,*,*,*,*,*,*,*,*,*,*,*,*,*,*,*,*