********************************************************************************
*..............**.....................................**.......................*
*........*............*.........*****...........*............*.........*****...*
*...................................*......................................*...*
*........**........****.............*...........**........****.............*...*
*........**..........**.............*...........**..........**.............*...*
*****...***..........**.............*...**********..........**.............*...*
*........**.....................................**.............................*
*........*****************.......***.**.........*****************.......***.**.*
*........................*............................*.........*..............*
*.........****************.......***.**.............***.................***.**.*
*.........*..............*.......................*..***.........*..............*
*.........*...******.....*.......*.****..........*..*******.....*.......*....*.*
*.........*...**.........*.......*....*..........*..***.........*.......*....*.*
*..****...*****....*.....*********....*...****...******...*.....*********....*.*
*.........**..........................*..........**.***......................*.*
*.........**.............**......................**.***.........**.............*
*..............................................................................*
*.........**.............**......................**.............**.............*
********************************************************************************