****************************************
*..............**......................*
*........*............*.........*****..*
*...................................*..*
*........**........****.............*..*
*........**..........**.............*..*
*****...***..........**.............*..*
*........**............................*
*........*****************.......***.***
*........................*.............*
*.........****************.......***.***
*.........*..............*.............*
*.........*...******.....*.......*.*****
*.........*...**.........*.......*....**
*..****...*****....*.....*********....**
*.........**..........................**
*.........**.............**............*
*......................................*
*.........**.............**............*
****************************************