*,*,*,*,*,*,*,*,*,*,*,*,*,*,*,*,*,*,*,*,*,*,*,*,*,*,*,*,*,*,*,*,*,*,*,*,*,*,*,*
*,.,.,.,.,.,.,.,.,.,.,.,.,.,.,*,*,.,.,.,.,.,.,.,.,.,.,.,.,.,.,.,.,.,.,.,.,.,.,*
*,.,.,.,.,.,.,.,.,*,.,.,.,.,.,.,.,.,.,.,.,.,*,.,.,.,.,.,.,.,.,.,*,*,*,*,*,.,.,*
*,.,.,.,.,.,.,.,.,.,.,.,.,.,.,.,.,.,.,.,.,.,.,.,.,.,.,.,.,.,.,.,.,.,.,.,*,.,.,*
*,.,.,.,.,.,.,.,.,*,*,.,.,.,.,.,.,.,.,*,*,*,*,.,.,.,.,.,.,.,.,.,.,.,.,.,*,.,.,*
*,.,.,.,.,.,.,.,.,*,*,.,.,.,.,.,.,.,.,.,.,*,*,.,.,.,.,.,.,.,.,.,.,.,.,.,*,.,.,*
*,*,*,*,*,.,.,.,*,*,*,.,.,.,.,.,.,.,.,.,.,*,*,.,.,.,.,.,.,.,.,.,.,.,.,.,*,.,.,*
*,.,.,.,.,.,.,.,.,*,*,.,.,.,.,.,.,.,.,.,.,.,.,.,.,.,.,.,.,.,.,.,.,.,.,.,.,.,.,*
*,.,.,.,.,.,.,.,.,*,*,*,*,*,*,*,*,*,*,*,*,*,*,*,*,*,.,.,.,.,.,.,.,*,*,*,.,*,*,*
*,.,.,.,.,.,.,.,.,.,.,.,.,.,.,.,.,.,.,.,.,.,.,.,.,*,.,.,.,.,.,.,.,.,.,.,.,.,.,*
*,.,.,.,.,.,.,.,.,.,*,*,*,*,*,*,*,*,*,*,*,*,*,*,*,*,.,.,.,.,.,.,.,*,*,*,.,*,*,*
*,.,.,.,.,.,.,.,.,.,*,.,.,.,.,.,.,.,.,.,.,.,.,.,.,*,.,.,.,.,.,.,.,.,.,.,.,.,.,*
*,.,.,.,.,.,.,.,.,.,*,.,.,.,*,*,*,*,*,*,.,.,.,.,.,*,.,.,.,.,.,.,.,*,.,*,*,*,*,*
*,.,.,.,.,.,.,.,.,.,*,.,.,.,*,*,.,.,.,.,.,.,.,.,.,*,.,.,.,.,.,.,.,*,.,.,.,.,*,*
*,.,.,*,*,*,*,.,.,.,*,*,*,*,*,.,.,.,.,*,.,.,.,.,.,*,*,*,*,*,*,*,*,*,.,.,.,.,*,*
*,.,.,.,.,.,.,.,.,.,*,*,.,.,.,.,.,.,.,.,.,.,.,.,.,.,.,.,.,.,.,.,.,.,.,.,.,.,*,*
*,.,.,.,.,.,.,.,.,.,*,*,.,.,.,.,.,.,.,.,.,.,.,.,.,*,*,.,.,.,.,.,.,.,.,.,.,.,.,*
*,.,.,.,.,.,.,.,.,.,.,.,.,.,.,.,.,.,.,.,.,.,.,.,.,.,.,.,.,.,.,.,.,.,.,.,.,.,.,*
*,.,.,.,.,.,.,.,.,.,*,*,.,.,.,.,.,.,.,.,.,.,.,.,.,*,*,.,.,.,.,.,.,.,.,.,.,.,.,*
*,*,*,*,*,*,*,*,*,*,*,*,*,*,*,*,*,*,*,*,*,*,*,*,*,*,*,*,*,*,*,*,*,*,*,*,*,*,*,*